"filename", "language", "Dart", "comment", "blank", "total"
"c:\Users\Kareem Ayman\Development\projects\flutter\tourista\lib\app.dart", "Dart", -1, 0, 0, -1
"c:\Users\Kareem Ayman\Development\projects\flutter\tourista\lib\config\routes\app_pages.dart", "Dart", -1, 0, 0, -1
"c:\Users\Kareem Ayman\Development\projects\flutter\tourista\lib\core\utils\app_bar_delegate.dart", "Dart", 8, 1, 0, 9
"c:\Users\Kareem Ayman\Development\projects\flutter\tourista\lib\core\utils\constants.dart", "Dart", 4, 0, -1, 3
"c:\Users\Kareem Ayman\Development\projects\flutter\tourista\lib\core\utils\sticky_title_delegate.dart", "Dart", 3, 0, -1, 2
"c:\Users\Kareem Ayman\Development\projects\flutter\tourista\lib\features\full_video\cubit\full_video.dart", "Dart", -2, 0, -1, -3
"c:\Users\Kareem Ayman\Development\projects\flutter\tourista\lib\features\full_video\screens\full_video_screen.dart", "Dart", 8, 0, -1, 7
"c:\Users\Kareem Ayman\Development\projects\flutter\tourista\lib\features\home\screens\home_screen.dart", "Dart", 30, 0, 1, 31
"c:\Users\Kareem Ayman\Development\projects\flutter\tourista\lib\features\navigation_page\screens\navigation_page.dart", "Dart", 34, 0, 0, 34
"c:\Users\Kareem Ayman\Development\projects\flutter\tourista\lib\features\place_video\screens\place_video_screen.dart", "Dart", 0, 0, -2, -2
"c:\Users\Kareem Ayman\Development\projects\flutter\tourista\lib\widgets\paragraph_widget.dart", "Dart", 5, 0, 0, 5
"c:\Users\Kareem Ayman\Development\projects\flutter\tourista\lib\widgets\place_card_widget.dart", "Dart", -1, 0, -2, -3
"Total", "-", 87, 1, -7, 81